# # # # # P # # # # 
# - - - - - - - - # 
# # - - - - # # - #
# # - - # - - - # #
# # - # # - # - - #
# - - - - - # # - #
# - # - - - # - - #
# - - - - - # - # #
# - - - - - - - - # 
# # # # # # # # F # 
