# # # # # # P # # # 
# - - - - - - - - # 
# - - # - - # - - #
# - - - - - - - - #
# - # - - - - # - #
# - - # - - - - # #
# - - - - # # - - #
# - # # - - - # # #
# - - - - - - - - # 
# # # # # F # # # # 
