# # # # # # P # # # 
# - - - - - - - - # 
# - # - - - - - # #
# - - - - - - - # #
# - - - - - # - - #
# - - # # # - # # #
# - - # - - - # # #
# - # # - - - # # #
# - - - - - - - - # 
# # # # F # # # # # 
