# # # # # # # # P # 
# - - - - - - - - # 
# - - - # - - - - #
# # - # - - # - - #
# # - - - - - # # #
# - # - # # # # # #
# # - - - - # - - #
# # # # - - - # - #
# - - - - - - - - # 
# # # # # # F # # # 
