# P # # # # # # # # 
# - - - - - - - - # 
# - - - # # - - - #
# - # - - # # # # #
# - - - - # - - # #
# # - - # - - - # #
# - # - - # # - - #
# # # - - - - # - #
# - - - - - - - - # 
# # # # # # # # F # 
